Md^Xm, Md^Xm, Md^Xm, Md^Xm, Md^Xm, Md^Xm, Md^Xm, Md^Xm, Md^Xm, Md^Xm, Md^Xm, Md^Xm, Md^Xm, Md^Xm, Md^Xm, Md^Xm, Md^Xm, Gg, Md^Xm, Md^Xm, Md^Xm, Md^Xm, Md^Xm, Md^Xm, Md^Xm, Md^Xm, Md^Xm, Md^Xm, Md^Xm, Md^Xm, Md^Xm, Md^Xm, Md^Xm, Md^Xm, Md^Xm, Md^Xm, Md^Xm, Md^Xm, Md^Xm, Md^Xm, Md^Xm, Md^Xm, Md^Xm, Md^Xm, Md^Xm, Md^Xm
Md^Xm, Md^Xm, Md^Xm, Md^Xm, Md^Xm, Md^Xm, Md^Xm, Md^Xm, Md^Xm, Md^Xm, Md^Xm, Md^Xm, Md^Xm, Md^Xm, Md^Xm, Md^Xm, Md^Xm, Md^Xm, Md^Xm, Md^Xm, Md^Xm, Md^Xm, Md^Xm, Md^Xm, Md^Xm, Md^Xm, Md^Xm, Md^Xm, Md^Xm, Md^Xm, Md^Xm, Md^Xm, Md^Xm, Md^Xm, Md^Xm, Md^Xm, Md^Xm, Md^Xm, Md^Xm, Md^Xm, Md^Xm, Md^Xm, Md^Xm, Md^Xm, Md^Xm, Md^Xm
Md^Xm, Md^Xm, Md^Xm, Md^Xm, Md^Xm, Md^Xm, Md^Xm, Md^Xm, Md, Md, Md, Md, Md, Md^Xm, Md^Xm, Md^Xm, Md^Xm, Md^Xm, Md^Xm, Md^Xm, Md^Xm, Md^Xm, Md^Xm, Md^Xm, Md^Xm, Md^Xm, Md^Xm, Md^Xm, Md^Xm, Md^Xm, Md^Xm, Md^Xm, Md^Xm, Md^Xm, Md^Xm, Md^Xm, Md^Xm, Md^Xm, Md^Xm, Md^Xm, Md^Xm, Md^Xm, Md^Xm, Md^Xm, Md^Xm, Md^Xm
Md^Xm, Md^Xm, Md^Xm, Md^Xm, Md^Xm, Md^Xm, Md^Xm, Md, Md, Md, Md, Md, Md, Md, Md, Md, Md, Md^Xm, Md, Md^Xm, Md, Md, Md, Md^Xm, Md^Xm, Md^Xm, Md, Md^Xm, Md^Xm, Md^Xm, Md, Md, Md, Md, Md, Md^Xm, Md, Md, Md, Md^Xm, Md, Md^Xm, Md^Xm, Md^Xm, Md^Xm, Md^Xm
Md^Xm, Md^Xm, Md^Xm, Md^Xm, Md^Xm, Md^Xm, Md, Md, Md, Md, Md, Md, Hhd, Hhd, Gs^Ft, Md, Hhd, Md, Md, Md, Hhd, Md, Md, Md, Md, Md, Md, Md, Md, Md, Hhd^Dr, Md, Md, Md, Md, Md, Md, Md, Md, Md, Md, Md, Md^Xm, Md^Xm, Md^Xm, Md^Xm
Md^Xm, Md^Xm, Md^Xm, Md^Xm, Md, Md, Hhd^Dr, Md, Hhd^Dr, Hhd^Dr, Hhd, Hhd, Gll, Gs^Ft, Gs^Ft, Hhd, Gll, Hhd^Dr, Gll^Ftr, Hhd, Sm^Qhu, Gs^Ft, Cfr, Md, Md, Md, Hhd, Hhd, Hhd, Hhd^Dr, Cfr, Hhd, Cfr, Hhd, Hhd, Md, Hhd^Dr, Hhd, Hhd, Md, Md, Md, Md^Xm, Md^Xm, Md^Xm, Md^Xm
Md^Xm, Md^Xm, Md, Md, Md, Hhd^Dr, Hhd, Hhd, Sm^Qhu, Hhd^Dr, Sm^Qhu, Gs^Ft, Gll, Gll, Rb^Edt, Re^Gvs, Rb^Edt, Ss, Sm^Qhu, Hhd^Ft, Ss, Hhd^Ft, Cfr, Rp, Rp, Cfr, Cfr^Ebn, Rp, Rp, Cfr, Rp, Rp, Rp, Cfr, Gs^Ft, Hhd^Dr, Hhd^Dr, Exos, Exos, Hhd^Dr, Hhd^Dr, Md, Md^Xm, Md^Xm, Md^Xm, Md^Xm
Md^Xm, Md^Xm, Md, Md, Gs^Ft, Gs^Ft, Gs^Ft, Ss, Sm^Qhu, Sm^Qhu, Gs^Ft, Chr^Dr, Re^Gvs, Rb^Edt, Re^Gvs, Re^Gvs, Rb^Edt, Rb^Edt, Rb^Dr, Sm^Qhu, Ss, Cfr, Cfr, Rp^Vhcr, Rp, Cfr, Rp^Vhcr, Gs^Ft, Hhd^Dr, Rp, Gs^Ft, Gs^Dr, Gll^Dr, Rp, Rp, Cfr^Ebn, Rp, Rp, Rp, Hhd^Dr, Cfr, Md, Md, Md^Xm, Md^Xm, Md^Xm
Md^Xm, Md, Md, Hhd, Gs^Ft, Ss, Hhd^Ft, Gs^Ft, Sm^Qhu, Sm^Qhu, Re^Gvs, Rb, Rb^Dr, Re^Gvs, Rb^Edt, Re^Gvs, Rb, Rb, Re^Gvs, Re^Gvs, Re^Gvs, Hhd, Rp, Gll, Exos, Rp, Rp, Gll^Dr, Hhd^Dr, Rp^Vhcr, Rp^Vhcr, Rp^Vhcr, Rp, Gll^Ebn, Gs^Ft, Rp, Rp^Vhcr, Hhd^Dr, Rp, Hhd^Ft, Hhd^Ft, Md, Md, Md^Xm, Md^Xm, Md^Xm
Md, Md, Md, Hhd, Sm^Qhu, Sm^Qhu, Gs^Ft, Gll^Ftr, Rb^Edt, Re^Gvs, Re^Gvs, Re^Gvs, Rb^Edt, Rb, Rb^Dr, Rb, Re^Gvs, Re^Gvs, Re^Gvs, Rb^Edt, Rb^Edt, Re^Gvs, Cfr^Ebn, Rp, Rp^Vhcr, Exos, Gll, Rp, Rp, Rp, Rp, Rp, Cfr, Rp, Rp, Gll, Gs^Ft, Rp^Vhcr, Rp, Hhd, Cfr^Ebn, Md, Md, Md^Xm, Md^Xm, Md^Xm
Md, Md, Md, Hhd, Sm^Qhu, Ss, Rb^Edt, Rb^Edt, Re^Gvs, Re^Gvs, Rb^Edt, Rb^Edt, Rb, Rb^Wm, Re^Gvs, Rb^Dr, Rb^Dr, Re^Gvs, Rb^Edt, Rb^Edt, Gll^Edb, Gll^Edb, Gll^Dr, Hhd^Dr, Rp, Rp^Vhcr, Gs^Ft, Exos, Rp, Gs^Ft, Rp, Cfr, 6 Kfr, Cfr, Rp, Gs^Ft, Rp^Vhcr, Gll, Gs^Ft, Rp, Cfr, Md, Md, Md^Xm, Md^Xm, Md^Xm
Md, Md, Hhd^Dr, Gs^Ft, Gs^Tf, Gs^Ft, Gs^Tf, Re^Gvs, Re^Gvs, Re^Gvs, Rb^Dr, Rb^Dr, Rb^Edt, Re^Gvs, Rb^Edt, Re^Gvs, Re^Gvs, Rb, Gll, Ss, Gll^Edb, Gll^Edb, Gs^Dr, Cfr, Cfr, Gll, Gll, Gs^Ft, Rp, Gll^Ebn, Rp, Cfr, Cfr, Cfr, Rp, Gs^Ft, Gs^Ft, Gs^Ft, Gll, Rp, Gs^Tf, Hhd, Md, Md, Md^Xm, Md^Xm
Md, Md, Hhd^Dr, Gll^Dr, Gll, Gll, Gll, Gll^Ftr, Gs^Ft, Rb, Re^Gvs, Rb^Edt, Re^Gvs, Rb^Edt, Rb^Edt, Re^Gvs, Gll, Gs^Ft, Hhd^Ft, Ss, Chr^Dr, Ss, Gll^Edb, Gll^Edb, Rp, Gs^Dr, Rp^Vhcr, Gs^Ft, Rp, Rp^Vhcr, Gs^Ft, Rp, Rp, Rp, Rp^Vhcr, Rp, Rp, Gll^Ebn, Rp^Vhcr, Rp, Hhd^Ft, Hhd, Md, Md, Md^Xm, Md^Xm
Hhd, Hhd, Gs^Ft, Gll^Dr, Gll^Edb, Gll^Emf, Gll^Emf, Gll, Gll, Gll, Gll, Re^Gvs, Re^Gvs, Rb^Edt, Gll, Gll, Gll^Ftr, Gs^Ft, Hhd^Ft, Hhd^Dr, Chr, Gll^Em, Gll^Edb, Gll^Edb, Rp, Rp, Rp, Rp, Gs^Dr, Rp^Vhcr, Rp^Vhcr, Gll, Rp, Gs^Ft, Gs^Ft, Rp^Vhcr, Rp, Gs^Ft, Gll, Rp, Cfr, Hhd, Md, Md, Md^Xm, Md^Xm
Gll, Gll^Em, Gs^Ft, Gs^Ft, Gll^Edb, Gll^Edb, Ss, Gll, Gll^Emf, Ss, Gll, Gll, Gs^Ft, Gll, Gs^Ft, Chr^Dr, Gll^Edb, Gll^Edb, Gll^Ftr, Gll^Ftr, Gll, Gll, Gs^Ft, Gs^Ft, Cfr^Ebn, Rp, Hhd^Dr, Rp, Rp, Rp, Rp, Gll^Dr, Hh, Rp, Gs^Ft, Hh, Rp, Rp^Vhcr, Rp, Rp, Hhd^Dr, Hhd, Md, Md, Md^Xm, Md^Xm
Gll, Gs^Ft, Chr^Dr, Gs^Vht, Gs^Ft, Gs^Ft, Ss, Gll, Gll, Gll^Emf, Gll, Gll, Gll, Gs^Ft, Sm^Qhu, Gll, Gll^Edb, Gll^Edb, Gll, Chr, Gs^Ft, Gll, Gll, Hh^Ft, Gs^Ft, Cfr, Ss, Cfr, Gll, Cfr, Hhd^Dr, Rp, Rp, Rp, Rp, Rp, Cfr^Ebn, Rp, Cfr, Hhd^Dr, Gs^Ft, Cfr^Ebn, Md, Md, Md^Xm, Md^Xm
Rrd, Gs^Ft, Gs^Ft, Gll, Gll, Gll^Em, Gs^Ft, Ss, Gll, Gll, Gll^Ftr, Gll, Gs^Ft, Sm^Qhu, Ss, Sm^Qhu, Ss, Sm^Qhu, Gll, Gs^Ft, Gs^Ft, Gs^Ft, Gs^Ft, Gs^Ft, Gs^Ft, Gs^Ft, Gs^Ft, Gs^Ft, Gs^Ft, Gll, Ss, Cfr, Rb, Cfr, Cfr, Hhd^Dr, Gll, Gs^Ft, Sm^Qhu, Ss, Rb, Rb, Hhd, Md, Md^Xm, Md^Xm
Wwg, Rrd, Wwg, Rrd, Rrd, Ss, Gll, Hhd^Edb, Gll^Edb, Gs^Ft, Gll, Gll, Gll, Hhd^Ft, Gs^Vht, Chr^Dr, Gs^Ft, Sm^Qhu, Gll^Ftr, Gll, Gs^Ft, Ss, Ss, Chr, Gll, Chr, Gll, Gll, Gll, Gll, Gs^Tf, Rb, Rb^Edb, Rb, Hh, Gll, Gll, Gs^Ft, Sm^Qhu, Sm^Qhu, Gs^Ft, Gs^Ft, Hhd^Dr, Md, Md, Md^Xm
Wog, Wwg, Wwg, Wwg, Wwg, Rrd, Rrd, Gll^Edb, Gll^Edb, Gs^Ft, Gs^Ft, Gll^Em, Gs^Ft, Hhd^Ft, Gs^Ft, Gs^Ft, Gll^Em, Gs^Ft, Hhd, Gll^Ftr, Gs^Vht, Gs^Ft, Sm^Qhu, Sm^Qhu, Gll, Gll, Gll^Edb, Gll^Edb, Gs^Tf, Gll, Gll, Gll^Edb, Gll^Edb, Gll, Gs^Ft, Gll, Gll, Gs^Ft, Gll, Hhd^Ft, Gs^Ft, Gll, Gs^Tf, Hhd^Dr, Md, Md
Wwg, Wog, Wwg, Wog, Wog, Wwg, Wwg, Rrd, Rrd, Gll, Gll, Gs^Ft, Gll^Em, Gs^Ft, Gll, Gs^Ft, Gs^Ft, Gll, Gll, Gs^Ft, Gll, Gs^Ft, Gs^Ft, Gll, Gs^Ft, Gll^Ftr, Gll^Edb, Gll^Edb, Gll, Gll, Gs^Ft, Chr, Gll, Gs^Ft, Gll, Gll^Ftr, Sm^Qhu, Gs^Ft, Gs^Ft, Gll^Em, Gll, Gll, Gs^Ft, Hhd, Hhd, Md
Rrd, Wwg, Rrd, Wwg, Wwg, Wog, Wwg, Wwg, Wwg, Rrd, Rrd, Gs^Ft, Gll^Ftr, Gll^Edb, Gll^Edb, Gs^Ft, Rrd, Gll, Rrd, Gll, Gll^Edb, Gll^Edb, Gll, Gll, Gll^Edb, Gs^Ft, Hhd^Ft, Hhd, Gll, Gll, Chr, Gll, Gll^Edb, Gs^Ft, Gll, Gll^Ftr, Ss, Sm^Qhu, Gs^Ft, Gs^Ft, Gll, Gll, Gs^Ft, Gs^Ft, Ss, Ss
Hhd, Gll, Chr, Rrd, Rrd, Wwg, Wog, Wog, Wog, Wwg, Wwg, Rrd, Rrd, Gll^Edb, Rrd, Rrd, Wwg, Wwg, Wwg, Rrd, Rrd, Gll^Edb, Gs^Ft, Gll^Edb, Gll^Edb, Gll, Gll, Gs^Ft, Hhd, Gll, Gs^Ft, Gll^Edb, Gll^Edb, Gll^Ftr, Gs^Ft, Gll, Gll^Emf, Hhd, Gll^Em, Gs^Ft, Hhd^Ft, Gll^Edb, Gll^Edb, Gll^Ftr, Gs^Ft, Gs^Ft
Gll, Hhd^Ft, Chr, Gll^Ftr, Gll, Wwg, Wwg, Wog, Wog, Wog, Wog, Wwg, Wwg, Rrd, Wwg, Wwg, Wog, Wog, Wwg, Wwg, Wwg^Bw/r, Rrd, Rrd, Hhd, Hhd, Gs^Tf, Gll^Edb, Gs^Ft, Gll, Gll^Ftr, Gs^Ft, Gs^Ft, Gs^Vht, Gs^Ft, Gs^Ft, Gll, Gll, Gll^Emf, Gll, Gs^Ft, Gll^Edb, Gll^Edb, Gll^Edb, Gs^Ft, Gll, Chr
Gs^Ft, Gs^Ft, 4 Khr, Chr, Hhd^Em, Rrd, Rrd, Wwg, Wwg, Wwg, Wwg, Wog, Wwg, Wwg, Wog, Wog, Wwg, Wwg, Wwg^Bw/r, Wog^Bw/r, Wog^Bw/r, Wwg^Bw/r, Wwg, Rrd, Rrd, Gll, Gll^Edb, Gll^Edb, Gs^Ft, Gll, Gll, Gs^Ft, Gll, Gll, Gll, Gll, Gs^Ft, Gll, Ss, Ss, Gll^Edb, Gs^Tf, Gll, Gll^Em, Gs^Ft, Gs^Ft
Gs^Ft, Gs^Vht, Chr, Chr, Gll, Gll, Gs^Ft, Rrd, Gs^Ft, Rrd, Rrd, Wwg, Wwg, Wog, Wwg, Wwg, Rrd, Rrd, Rrd, Wwg^Bw/r, Wwg, Wog, Wog, Wwg, Wwg, Gll^Edb, Gs^Ft, Gll, Gs^Ft, Gll^Ftr, Gs^Ft, Gll, Gs^Ft, Gs^Ft, Gll, Gll, Hhd^Ft, Gll, Gll, Gs^Ft, Gll, Gll, Gll^Ftr, Chr, Gll, Gs^Ft
Gs^Ft, Chr, Hhd, Sm^Qhu, Sm^Qhu, Gll^Em, Gll, Gll, Gs^Ft, Gll^Em, Ss, Rrd, Rrd, Wwg, Rrd, Rrd, Gll, Gs^Ft, Gs^Ft, Rrd, Rrd, Wwg, Wog, Wog, Wwg, Rrd, Gll, Gs^Ft, Gll, Gll^Ftr, Gll, Hhd^Dr, Gll, Gll, Gs^Ft, Hhd, Gs^Ft, Gll^Ftr, Gll^Ftr, Gll, Chr, Gs^Ft, Gll, Gll, Gll, Gs^Ft
Gll, Gs^Ft, Gs^Ft, Sm^Qhu, Gll, Chr, Gs^Ft, Gll, Gll^Edb, Gll^Edb, Gs^Ft, Gll, Gll, Gll, Ss, Gs^Ft, Gs^Ft, Gll^Ftr, Gs^Ft, Gll^Ftr, Gll^Em, Wwg, Wwg, Wog, Wwg, Rrd, Rrd, Gll, Gs^Ft, Gll, Gs^Ft, Gs^Ft, Gll, Gll^Emf, Gs^Ft, Gs^Ft, Gll, Gs^Vht, Gs^Ft, Gs^Ft, Gll, Gll, Gs^Tf, Gs^Ft, Gs^Ft, Gll
Gll, Chr, Sm^Qhu, Ss, Gll, Gll, Gll, Gs^Ft, Gll^Edb, Gll^Edb, Gll, Gll, Hhd, Ss, Ss, Ss, Hhd^Ft, Gll, Gs^Ft, Gll^Emf, Gll^Edb, Rrd, Wwg, Wwg, Wog, Wwg, Wwg, Rrd, Wwg, Rrd, Rrd, Hhd^Dr, Hhd, Gll, Gs^Ft, Gll, Gll, Gs^Ft, Gll^Ftr, Hhd^Ft, Gs^Ft, Gs^Ft, Gll, Gll^Ftr, Gll^Em, Gll
Gs^Ft, Sm^Qhu, Hhd^Ft, Gs^Ft, Gll, Gll^Emf, Gll^Emf, Gs^Vht, Gs^Ft, Gs^Ft, Chr, Gll, Gll^Em, Gll^Ftr, Chr, Gll, Chr, Gll, Gs^Ft, Gll^Edb, Ss, Rrd, Rrd, Wwg, Wwg, Wog, Wog, Wwg, Wog, Wwg, Wwg, Rrd, Gll^Ftr, Gll, Gll, Gs^Ft, Gs^Ft, Gs^Ft, Gll^Emf, Gll^Em, Hhd^Ft, Gs^Ft, Gs^Ft, Gll, Gs^Ft, Ss
Gs^Ft, Sm^Qhu, Gll^Ftr, Gs^Ft, Gll, Gll^Edb, Gll^Edb, Gll^Edb, Gll^Em, Gll, Gs^Ft, Gs^Ft, Gll^Edb, Chr, Gll^Ftr, Khr, Gs^Ft, Gll, Gll, Hhd^Ft, Sm, Ss, Gs^Ft, Rrd, Rrd, Wwg, Wwg, Wog, Wog, Wog, Wwg, Rrd, Hhd^Ft, Gll, Hhd^Dr, Gs^Ft, Gll^Emf, Gll^Emf, Gll, Gll, Gs^Ft, Gll, Gll, Gs^Vht, Chr, Gs^Ft
Hhd, Chr, Gll, Hhd, Gll, Gs^Ft, Gll, Gll, Chr, Gll, Gll, Gll^Edb, Gll^Edb, Hhd^Ft, Ss, Gll, Gll, Gll, Gll^Ftr, Gs^Ft, Ss, Sm, Hhd^Ft, Gll, Gs^Ft, Rrd, Rrd, Wwg, Wwg, Wog, Wwg, Rrd, Rrd, Gll^Edb, Gll^Edb, Gll, Gll^Edb, Gll^Edb, Gs^Ft, Gll, Gs^Ft, Gll, Chr, Gs^Ft, Gll, Gll
Md, Hhd, Hhd, Gll^Em, Gll, Gs^Ft, Ss, Gll^Ftr, Gll, Gll, Gll^Ftr, Gs^Ft, Gll, Gll^Edb, Gll^Edb, Gll, Gll^Ftr, Hhd, Gll^Edb, Gll^Edb, Hhd, Sm, Gs^Vht, Gs^Ft, Gll, Gll^Ftr, Gll, Rrd, Wwg, Wwg, Wog, Wwg, Wwg^Bw/r, Rrd, Rrd, Gll^Ftr, Gll^Emf, Gll^Edb, Gll^Ftr, Gll^Em, Hhd^Ft, Hhd, Gll^Ftr, Chr, Gs^Ft, Gs^Ft
Md, Md, Hhd, Chr, Gs^Ft, Gll, Gs^Ft, Gs^Ft, Chr, Gll, Gll, Gs^Ft, Ss, Gll^Edb, Gll^Edb, Gll, Gll^Emf, Gll, Gs^Ft, Gll^Edb, Gll^Edb, Gll, Gs^Tf, Gs^Ft, Gs^Ft, Gll, Gll^Ftr, Gs^Ft, Rrd, Wwg, Wwg^Bw/r, Wog^Bw/r, Wog^Bw/r, Wwg^Bw/r, Wwg, Rrd, Rrd, Gll, Gll, Chr, Gs^Tf, Gll, Gs^Ft, Chr, Hhd, Gs^Ft
Md^Xm, Md, Md, Hhd, Gs^Ft, Chr, Gll, Gs^Ft, Gll^Edb, Gll^Em, Gll^Ftr, Gs^Ft, Gll, Gs^Vht, Gs^Ft, Gll^Emf, Gll^Emf, Gll, Hhd^Ft, Gll, Gll^Edb, Gll^Edb, Gll, Gll, Chr, Gll, Ss, Gll^Ftr, Gll, Rrd, Rrd, Wwg^Bw/r, Wwg, Wwg, Wog, Wwg, Wwg, Gs^Ft, Gs^Ft, Gs^Ft, Gll, Chr, Chr, 5 Khr, Chr, Gs^Ft
Md^Xm, Md, Md, Hhd, Gs^Ft, Gll^Ftr, Gs^Ft, Gll, Gll^Edb, Gll^Edb, Chr, Gs^Tf, Gll, Gll, Gll, Gll^Emf, Gll, Gll, Gs^Ft, Gs^Ft, Gll^Ftr, Gll^Edb, Chr, Gs^Ft, Gll, Gll, Gs^Ft, Gll, Gll, Gs^Ft, Chr, Rrd, Rrd, Wwg, Wog, Wog, Wwg, Rrd, Rrd, Gll, Rrd, Gll, Rrd, Gll^Em, Gll, Gll
Md^Xm, Md^Xm, Md, Hhd, Chr, Gs^Ft, Gll^Edb, Gll, Gs^Ft, Gll, Gs^Ft, Gs^Ft, Gs^Ft, Gs^Ft, Gll, Gll, Gll, Gs^Ft, Gll, Hhd^Ft, Gll, Gll, Gll^Ftr, Hhd^Ft, Ss, Gll, Gs^Ft, Gs^Ft, Gll, Hhd^Ft, Gll, Gll, Gs^Ft, Wwg, Wwg, Wog, Wwg, Wwg, Wwg, Rrd, Wwg, Wwg, Wwg, Rrd, Rrd, Chr
Md^Xm, Md^Xm, Md, Hhd, Gll, Gll^Edb, Gll^Edb, Gs^Ft, Gll, Gs^Ft, Gll, Gll^Em, Gs^Ft, Hhd, Hhd, Gs^Ft, Gll, Hhd^Ft, Gs^Ft, Gll, Gll^Edb, Gs^Ft, Gs^Tf, Gs^Ft, Gll, Gs^Ft, Gs^Ft, Gs^Ft, Chr, Chr, Gll, Gs^Ft, Chr, Rrd, Rrd, Wwg, Wwg, Wog, Wog, Wwg, Wog, Wwg, Wog, Wwg, Wwg, Rrd
Md^Xm, Md^Xm, Md^Xm, Md, Hhd, Gll, Gll^Ftr, Gll^Ftr, Gs^Ft, Gs^Ft, Gll, Gs^Ft, Gll, Gll, Gll^Ftr, Gll, Gs^Ft, Gs^Tf, Gs^Ft, Hhd, Gll^Edb, Gll^Edb, Gll^Ftr, Gll, Gll^Ftr, Gll, Gll, Gll, Gs^Ft, Hhd^Ft, Gll, Gll, Gs^Ft, Gll, Gll, Rrd, Rrd, Wwg, Wwg, Wog, Wwg, Wwg, Wwg, Wog, Wog, Wwg
Md^Xm, Md^Xm, Md^Xm, Md, Hhd, Gll, Gll, Gll^Em, Gs^Ft, Gll, Ss, Gs^Ft, Gs^Ft, Gs^Tf, Ss, Gs^Ft, Gll, Gll, Gll^Edb, Gs^Ft, Gll, Gll^Edb, Gll^Ftr, Gll, Gs^Ft, Hhd, Gll, Chr, Gs^Ft, Gll, Gll, Gs^Ft, Gll, Chr, Gs^Ft, Gll, Gll^Edb, Rrd, Rrd, Wwg, Rrd, Rrd, Rrd, Wwg, Wwg, Wog
Md^Xm, Md^Xm, Md^Xm, Md^Xm, Hhd, Chr, Gs^Ft, Gll, Gs^Vht, Gs^Ft, Gll, Gll^Edb, Gll^Em, Gll, Gll, Gll, Chr, Ss, Gs^Ft, Gll^Edb, Gll, Gll, Hhd, Gs^Ft, Gll^Edb, Gll^Edb, Gll^Em, Gll, Gs^Ft, Hhd^Ft, Gll, Hhd, Gll, Sm^Qhu, Ss, Gs^Ft, Gll^Edb, Gll^Edb, Gs^Ft, Hhd^Ft, Gll, Gs^Ft, Gll^Ftr, Rrd, Rrd, Wwg
Md^Xm, Md^Xm, Md^Xm, Md, Hhd, Gll, Gll^Edb, Gll^Edb, Gll, Gs^Ft, Gll^Edb, Gll^Edb, Gll^Edb, Gs^Ft, Gs^Ft, Gs^Tf, Gs^Ft, Gll, Gll, Gll^Ftr, Gll^Edb, Gs^Ft, Gs^Ft, Gll, Ss, Gll^Edb, Hhd, Gs^Ft, Gs^Ft, Gs^Ft, Gs^Ft, Hhd^Ft, Hhd^Ft, Sm^Qhu, Sm^Qhu, Gs^Ft, Ss, Hhd^Ft, Gll^Em, Gll, Gs^Ft, Chr, Gll, Gs^Ft, Gll, Rrd
Md^Xm, Md^Xm, Md^Xm, Hhd, Gs^Ft, Gll, Hhd^Ft, Gll^Edb, Gs^Ft, Gll, Gs^Ft, Gll^Edb, Gll, Gs^Ft, Gs^Ft, Gll, Gs^Ft, Gll, Gll^Emf, Gll, Gll^Edb, Gll^Edb, Gll, Gll, Gll, Gll, Hhd^Ft, Gs^Ft, Gs^Ft, Gll, Gll, Gs^Ft, Gs^Vht, Gll^Ftr, Gs^Ft, Gs^Ft, Gs^Ft, Gs^Ft, Gll^Ftr, Gll, Gll, Gll, Gs^Ft, Hhd, Ss, Gll
Md^Xm, Md^Xm, Md, Md, Hhd, Gll^Em, Gs^Ft, Gs^Ft, Gs^Ft, Gll, Gs^Ft, Gll^Edb, Ss, Gs^Ft, Gs^Ft, Gll, Gs^Ft, Hhd, Gll^Emf, Gll^Emf, Gll, Gll^Edb, Gs^Ft, Gll, Chr, Gs^Ft, Gll, Gs^Ft, Gs^Ft, Gs^Ft, Gs^Ft, Gll, Gs^Ft, Gs^Ft, Gs^Ft, Gll, Gs^Ft, Gll^Em, Gs^Ft, Gs^Ft, Gll, Gs^Vht, Gll, Sm^Qhu, Sm^Qhu, Hhd^Ft
Md^Xm, Md^Xm, Md, Hhd, Hhd, Gll, Chr, Gs^Ft, Gs^Ft, Gll, Gll^Edb, Gs^Ft, Gll, Gll, Gll, Gll^Ftr, Gs^Ft, Gll, Gs^Ft, Hhd, Gll, Gs^Vht, Gs^Ft, Gll, Gll, Hhd, Chr, Gll, Gll, Gll^Em, Gs^Ft, Gll, Hhd^Ft, Gs^Ft, Gll, Gs^Ft, Gs^Ft, Gll, Gs^Ft, Gll^Em, Gll^Edb, Gs^Ft, Gs^Ft, Gs^Ft, Gs^Ft, Gs^Ft
Md^Xm, Md^Xm, Md, Hhd, Gs^Ft, Gll, Gll^Em, Gs^Tf, Gll, Gll^Edb, Gll^Edb, Gll^Edb, Gll, Gs^Ft, Gs^Ft, Gll, Gll, Gll, Gll, Chr, Gs^Ft, Gs^Ft, Gll, Gll, Chr, Gll, Gll^Em, Gs^Ft, Gll^Edb, Gll^Edb, Gll^Edb, Gs^Ft, Chr, Ss, Gll, Gll^Ftr, Hhd, Chr, Gs^Ft, Ss, Gll^Edb, Gll^Edb, Ss, Sm^Qhu, Sm^Qhu, Gll
Md^Xm, Md, Hhd, Gll, Gll, Gll^Ftr, Gll, Gll, Gll, Gll^Edb, Ss, Gll, Gs^Ft, Gll, Gll, Gs^Ft, Gs^Ft, Gll, Hhd^Dr, Gs^Ft, Gll, Gll, Gs^Ft, Gll, Gll^Ftr, Gll, Gll, Gs^Ft, Hhd, Gll^Edb, Gs^Ft, Gs^Ft, Hhd^Ft, Chr, Gs^Ft, Gll^Edb, Gll^Edb, Gll, Gs^Ft, Gll, Gll^Ftr, Gll^Edb, Gll^Em, Gll^Ftr, Sm^Qhu, Ss
Md^Xm, Md, Hhd, Gll, Hhd, Gll, Hhd, Gs^Ft, Gll, Gs^Ft, Gs^Ft, Gs^Ft, Gs^Ft, Gs^Ft, Gll, Gs^Tf, Gs^Ft, Hhd^Dr, Md, Gs^Ft, Gll, Gll, Gll, Gll^Edb, Gll^Edb, Chr, Gll, Gll, Gll, Gll^Edb, Gll, Gs^Ft, Gll, Gll, Gll^Ftr, Gll^Edb, Gll^Edb, Gs^Vht, Gs^Ft, Gll, Gll, Gll, Hhd^Ft, Gs^Ft, Gs^Ft, Gll
Md, Md, Hhd, Gll^Ftr, Gll^Ftr, Gs^Ft, Gs^Ft, Gll^Ftr, Gll, Gs^Ft, Gs^Ft, Gll^Ftr, Gll, Ss, Gs^Ft, Gll, Hhd, Md, Md^Xm, Md, Hhd, Gs^Ft, Gs^Ft, Gll^Em, Gll^Edb, Gll^Edb, Gll, Gs^Ft, Gs^Ft, Gll, Gs^Tf, Hhd, Gll, Ss, Gll, Hhd, Gll^Edb, Gll, Gs^Ft, Gs^Ft, Gs^Ft, Gll, Gs^Ft, Gll, Gll, Ss
Hhd, Hhd, Gll, Gll^Em, Re^Vct, Gs^Ft, Gll, Gs^Ft, Gs^Ft, Gll, Gll^Em, Gs^Ft, Gs^Ft, Gll, Hhd^Dr, Hhd^Dr, Md, Md, Md^Xm, Md, Hhd, Gs^Ft, Gs^Vht, Gs^Ft, Gs^Ft, Gll^Edb, Gll, Gll, Gll, Gll, Gll, Hhd^Ft, Gll, Ss, Hhd^Ft, Gll^Edb, Gll^Edb, Gs^Ft, Gs^Ft, Ss, Sm^Qhu, Gll, Gll^Em, Hhd, Gs^Tf, Gll
Gll, Gll, Ss, Re^Vct, Gs^Ft, Re^Vct, Gll^Ecf, Gll, Gll, Gll, Gs^Ft, Gs^Ft, Hhd^Dr, Gll^Em, Md, Md, Md, Md^Xm, Md^Xm, Md, Hhd^Dr, Gs^Ft, Gll, Gs^Ft, Gll, Gll, Gll, Hhd^Ft, Gll^Ftr, Gll, Gll, Gll, Gs^Ft, Gs^Ft, Gs^Ft, Gs^Ft, Gll, Gll^Edb, Gll, Sm^Qhu, Gs^Ft, Hhd, Gs^Ft, Gs^Ft, Gs^Ft, Gs^Ft
Gs^Ft, Gs^Ft, Gll^Ecf, Gll^Ftr, Chr, Chr, Ce, Gll, Re^Vct, Gs^Ft, Hhd, Hhd, Md, Hhd^Dr, Md, Md^Xm, Md^Xm, Md^Xm, Md, Hhd, Re^Vct, Re^Vct, Ce, Gll, Re^Vct, Gll^Ebn, Gll, Gll^Emf, Gll^Emf, Gs^Ft, Gll, Gs^Ft, Gll, Gll, Gll, Gs^Ft, Chr, Hhd, Gs^Ft, Gs^Ft, Gll^Em, Gs^Tf, Gs^Ft, Gll, Gll, Gs^Ft
Gll, Gll, Ce, Ce, 2 Khr, Ce, Ce, Gs^Ft, Gs^Ft, Gs^Ft, Md, Md, Md, Md, Md^Xm, Md^Xm, Md^Xm, Md, Md, Gll^Ebn, Ce, Chr, Ce, Ce, Gs^Ft, Re^Vct, Gll^Ftr, Gll^Edb, Gll^Edb, Gll^Em, Gll, Gs^Ft, Gll^Ftr, Gll^Emf, Gll^Emf, Gll^Edb, Gs^Ft, Gll^Ftr, Gs^Ft, Gll, Hhd^Ft, Chr, Chr, Chr, Chr, Hhd^Ft
Gll, Gll, Chr, Chr, Chr, Chr, Gll, Gs^Ft, Hhd, Hhd, Hhd, Md, Md^Xm, Md^Xm, Md^Xm, Md^Xm, Md, Md, Hhd^Dr, Ce, Chr, 1 Khr, Chr, Ce, Gll, Gs^Ft, Chr, Gll^Edb, Gll^Edb, Gs^Ft, Gs^Ft, Gs^Ft, Gs^Vht, Gll, Gll, Gll^Edb, Gll, Gll^Em, Hhd, Ss, Sm^Qhu, Gs^Ft, Chr, 3 Khr, Chr, Ss
Gll, Gll, Re^Vct, Ce, Gll, Gll^Ftr, Re^Vct, Re^Vct, Gs^Ft, Md, Md, Md, Md^Xm, Md^Xm, Md^Xm, Md^Xm, Md, Hhd^Dr, Gs^Ft, Ce, Chr, Chr, Gll, Gll^Ebn, Re^Vct, Hhd^Ft, Gs^Ft, Gs^Ft, Ss, Gll, Gs^Ft, Gll^Em, Gll^Ftr, Ss, Gll^Ftr, Gs^Ft, Hhd, Gs^Ft, Hhd^Ft, Sm^Qhu, Gll^Em, Hhd, Gs^Ft, Chr, Gll, Gs^Ft
Gll, Gll, Gll, Gs^Ft, Gll^Ftr, Re^Vct, Gs^Tf, Gll^Ecf, Hhd, Hhd, Md, Md, Md^Xm, Md^Xm, Md^Xm, Md, Md, Gs^Ft, Gs^Ft, Gll^Ftr, Gs^Ft, Gll, Hhd^Ft, Re^Vct, Hhd^Ft, Gs^Ft, Gll^Em, Gs^Ft, Gll, Gll^Ftr, Gll^Ftr, Gll, Gll^Edb, Gll^Edb, Hhd, Ss, Gll^Ftr, Gll^Ftr, Ss, Sm^Qhu, Gs^Ft, Gll, Gll, Chr, Gll, Gll
Gs^Ft, Gll, Gs^Ft, Gs^Ft, Gs^Ft, Chr, Gll, Hhd, Hhd, Md, Md^Xm, Md^Xm, Md^Xm, Md^Xm, Md, Md, Hhd, Hhd^Dr, Gll, Gs^Vht, Gs^Tf, Gs^Ft, Gs^Ft, Gs^Tf, Gll, Gs^Ft, Gll^Edb, Gll^Edb, Hhd, Gs^Ft, Gll, Gll, Gll^Edb, Gll^Edb, Gll, Gll, Gll, Sm^Qhu, Sm^Qhu, Sm^Qhu, Gll^Ftr, Gs^Ft, Gs^Vht, Gs^Ft, Gs^Ft, Gll
Gs^Ft, Gll, Gll, Gll, Gll, Gs^Ft, Hh^Ft, Hhd, Mm, Md^Xm, Md^Xm, Md^Xm, Md^Xm, Md^Xm, Md, Md, Md, Hhd, Gll, Hhd, Gll, Gll, Gll, Gs^Ft, Gll, Gll, Gll^Edb, Gll^Edb, Gs^Ft, Gs^Ft, Gll, Gll^Edb, Gll^Edb, Gs^Ft, Gll, Gll, Gs^Ft, Gs^Ft, Gll, Gll, Gll, Gll, Gll, Gll, Gll^Ftr, Gll^Ftr
